XXXXXXXXXXXXXXXXXXXXXXX
X              .
X .                     .
X   
X           .                        XXXXXXXX
XXXXXXX                    .       XX    XXX
X    .           XXXXXXXXX       .    XXXXXX                 
X               X        X
X   P           XXXXXXXXX
X          .                 .
X
X  .
XXXXXXXXXXXXXXXXXXXXXXXXXXXXXXX
