                    .                         .
                            .
   .             .                                 .                  .
     X
     X           XXXXXXXXXXXXXXXXXXXXXXX
     X XX        X  XX    X X    .      X                         .
   XX.X          X .                     .
  X  XX           X     
   XXX          XX      .                             XXXXXXXX
XXXXXXXX    XXXXXXX                    .             XX    XXX  X
  .          .    X    .         XXXXXXXXX           .     X XXXXXX                 .
                X               X        XX                X
                X                XXXXXXXXX
                X          .      X    XX       .                      .
                X                    P                                                               .
                XX                                                
                X                                      XXXXXXXX                                    XXXX                                 XXXX    XXXX
                X                                  XXXXXX    X    XXXXXXXXX    XXXXX   XXXXXXXXXXXX                      XXX    X
 XXXXXX  .       X                            XXXXX            XX     .         XX    X  XX X    X
                X  .                          X         XXXXXXXXXXXXX            X
                XXXXXXXXXXXXXXXXXXXXXXXXXXXXXXX          .X
.       .        X      XX  X             X  X
                     .




XXXXXXXXXXXXXXXXXXXXXXXXXXXXXXXXXXXXXXXXXXXXXXXXXXXXXXXXXXXXXXXXXXXXXXXXXXXXXXXXXXXXXXXXXXXXXXXXXXXXXXXXXXXXXX