.......................................
.......................................
...............qYYYYYYYYYYYw...........
....qYYYYYYYYYYG  z        U...........
....I         1   x   b b  U...........        
....I   P     x  avb3 x x <U...........
....I#vbv NvSD@@@@STTD$$$STO...........
....yWWWWWWWOMWWWWt..MTTTO.............
.......................................
.......................................
