########      #####################
r       r      l                   l
r       r      l                   l
r       dddddddd                   l
r P                                l
r                                  l
r                                  l
r                                  l
r                           f     uu
r                          #######                     
r##########################