#########      #####################
x       x      x                   x
x       x      x                   x
x       xxxxxxxx                   x
x P                                x
x                                  x
x                                  x
x                                  x
x                           f     xx
x                          #######                     
x##########################