........................................
........................................
........................................
....qYYYYYYYYYYYYYYYYYYYYw...............
....I                   U...............         
....I  P   4 x    3 x  2U...............
....I 1   SD@@@STTD$$$STO...............
....yWWWWWtyWWWt..yWWWt.................
........................................
........................................
