..I                           U.....
..I                           U.....
..I            b            < U.....
..IP         # a z      2   Q U.....
..Ibv        a b a     vbvba2 U.....
..IWR v #vbv   x 2 #bv4EWWR@@@U.....
..I.I&EWWWWWR@@@@@@EWWWO..MWWWU.....
..I.MTO.....MWWWWWWO................
..I.................................